C 135,206,255
WE ./textures/walls/weast.png
EA ./textures/walls/east.png
NO ./textures/walls/north.png

SO ./textures/walls/south.png

F ,105,84,71

111111111
100000001
100000001
10d000S01
10D000001
100000001
111111111