SO ./textures/walls/south.png
WE ./textures/walls/weast.png
EA ./textures/walls/east.png
NO ./textures/walls/north.png

C 135,206,235
F 105,84,71

        11111111111111111111111111
        100000S000110000000000001
        1011000001110000000000001
        100100d0000d0000000000001
11111111101100D001110000000000001
100000000011D11001110111111111111
11110111111111011100000010001
11110111111111011101010010001
11000000110101011100000010001
1000000000000001100000010001
10000000000000001101010000001
1100000111010101111101111000111
11110111 1110101 101111010001
11111111 1111111 111111111111