SO ./south
WE ./west
EA ./eastgghfj
NO ./north

C 135,206,235
F 105,84,71

        1111111111111111111111111
        1000000000110000000000001
        1011000001110000000000001
        10010000000000000N0000001
111111111011000001110000000000001
100000000011000001110111111111111
11110111111111011100000010001
11110111111111011101010010001
11000000110101011100000010001
100000000000000000000000010001
10000000000000001101010000001
1100000111010101111101111000111
11110111 1110101 101111010011
11111111 1111111 11111111111 
