SO ./south
WE ./west
EA ./east
NO ./north

C 135,206,235
F 105,84,71

        1111111111111111111111111
        1000000000110000000000001
        1011000001110000000000001
        1001000000000000000000001
111111111011000001110000000000001
100000000011000001110111111111111
101000101011110111000000100011
100000011D11111011101010010001
100011111011010111000000100011
1000d000S000000000000000010001
100011110000000011010100000011
1000100111010101111101111000111
10000111 1110101 101111010011
11111111 1111111 11111111111 
