SO ./south
WE ./west
EA ./eastgghfj
NO ./north

C 135,206,235
F 105,84,71

        1111111111111111111111111
        1000000000110000000000001
        1011000001110000000000001
        1001000000000000000000001
111111111011000001110000000000001
100000000011000001110111111111111
1010D010111111011100000010001
11100010111111011101010010001
11DD1D10110101011100000010001
1000d00000N0000000000000010001
10001000000000001101010000001
1100100111010101111101111000111
11111111 1110101 101111010011
11111111 1111111 11111111111 
