SO ./textures/walls/south.png
WE ./textures/walls/weast.png
EA ./textures/walls/east.png
NO ./textures/walls/north.png

C 135,206,235
F 105,84,71

        1111111111111111111111111
        1000000000110000000000001
        1011000001110000000000001
        1001000000000000000000001
111111111011000001110000000000001
100000000011000001110111111111111
101000101011110111000000100011
100000011D11111011101010010001
100011100011010111000000100011
1000d000N000000000000000010001
100010000000000011010100000011
10001000000B0101111101111000111
1000011000000101 101111010011
1111111111111111 11111111111 
